TTTTT.~....TTT.TTTTT
TTTTT.~...TTTT.TTTTT
TTTTT.~...T.TT.TTTTT
TTTTT.~...TTTT.TTTTT
TTTT..~..TTTTT.TTTTT
....................
TTTT.~...TTTTT.TTTTT
TTT..~..TTTTTT.TTTTT
TTT.~~..TTTTTT.TTTTT
TTT.~...TTTTTT.TTTTT
TTT.~...TTTTTT.TTTTT
TTT.~...TTTTTT.TTTTT
TTT.~...TTTTTT.TTTTT
TTT.~...TTTTTT.TTTTT
TTT.~...TTTTTT.TTTTT
TTT.~...TTTTTT.TTTTT
TTT.~...TTTTTT.TTTTT
TTT.~...TTTTTT.TTTTT
